TILEMAP
36 28 							-- Size of tile map in tiles
16 32 							-- Tile size & block size
images/blocks.png 	-- Tilesheet
2 2 								-- Number of tiles in tilesheet
                                    
111111111111111111111111111111     1
          1111              11     1
          1111              11     1
          1111              11     1
          1111              11     1
          1111              11     1
          1111              11     1
          1111              11     1
          1111              11     1
          1111              11     1
          1111              11     1
          1111              11     1
          1111    2222      11     1
          1111    1111      11     1
          1111    1111             1
                  1111             1
                  1111             1
                  1111             1
                  1111             1
                  1111             1
                  1111             1
11111111111111    1111             1
11111111111111    1111             1
11111111111111    1111       1111111
11111111111111    1111       1111111
111111111111112222111122222221111111
111111111111111111111111111111111111