TILEMAP
36 28 							-- Size of tile map in tiles
16 32 							-- Tile size & block size
images/blocks.png 	-- Tilesheet
2 2								-- Number of tiles in tilesheet
                                    
11111111111      1111111111111111111
                                  11
                                  11
                                  11
                                  11
                                  11
           111111                 11
           111111                 11
             1111        1111     11
             1111     2221111     11
             1111     1111111     11
             1111     1111111  3  11
             1111     11111111111111
             1111     1111111     11
             1111     1111111     11
             1111     1111111     11
             1111     1111111     11
             1111     1111111     11
                      1111111     11
                      1111111     11
                      1111111     11
1111111               1111111     11
1111111                           11
1111111         1111              11
1111111                           11
111111122222222222222222222222222211
111111111111111111111111111111111111