TILEMAP
36 28 							-- Size of tile map in tiles
16 32 							-- Tile size & block size
images/blocks.png 	-- Tilesheet
2 2 								-- Number of tiles in tilesheet
1111111111111           111111111111
111       111           111111111111
11                      111111111111
11                      111111111111
1                           11111111
     22222222               11111111
     11111111      11          21111
     11111111                  21111
   1111111                  11111111
   1111111                1111111111
     11111              111111111111
     11111                1111111111
     11111                1111111111
     11111                       211
     11111                       211
                                 211
                                 211
             1111                211
222222222222211                  211
1111111111111                       
11                    4444          
11                                  
                                    
                                    
            4444                    
                                    
   11111                            
   11111                            