TILEMAP
36 28 							-- Size of tile map in tiles
16 32 							-- Tile size & block size
images/blocks.png 	-- Tilesheet
2 2								-- Number of tiles in tilesheet
                                    
1111111111111111111111111111       1
1                                  1
1                                  1
1                                  1
1                                  1
1                                  1
1                                  1
1                                  1
1                                  1
1         11             11111     1
1                          111     1
1                          111     1
1                          111     1
1                          111     1
1                          111     1
1                          111     1
1                          111     1
1                          111     1
1                          111     1
1                          111     1
1                          111     1
1                          111     1
1                          111     1
1                          111     1
11111                      111     1
111112222222222222222222222111222221
111111111111111111111111111111111111              