TILEMAP
36 28 							-- Size of tile map in tiles
16 32 							-- Tile size & block size
images/blocks.png 	-- Tilesheet
2 2								-- Number of tiles in tilesheet
                                    
11     11111111111111111111111111111
11                             11111
11                             11111
11                             11111
11                             11111
11111111111111111111           11111
1              11111111        11111
1              11111111111     11111
1              11111111111     11111
1              11111111111     11111
1              11111111111     11111
1        11111111111111111     11111
1        11111111111111111     11111
1        11111111111111111     11111
1                              11111
1                              11111
1                                  1
1                                  1
1                                  1
1                                  1
11111                              1
1111111                            1
111111111                     222221
111111111111111      11       111111
111111111111111      112222222111111
111111111111111222222111111111111111
111111111111111111111111111111111111