TILEMAP
36 28 							-- Size of tile map in tiles
16 32 							-- Tile size & block size
images/blocks.png 	-- Tilesheet
2 2 								-- Number of tiles in tilesheet
11111111111      1111111111111111111
11111111111      1111111111111111111
11                                 1
11                                 1
11                                 1
11         111111                  1
11         111111                  1
11         111111                  1
11         111111                  1
11           1111      1111        1
11           1111                  1
11           1111                  1
11           1111                  1
11           1111                  1
11           1111                  1
11           1111      1111        1
11           1111                  1
11           1111                  1
11           1111                  1
11                           1111  1
11                                 1
11                                 1
1111111                  1111      1
1111111                            1
1111111         1111               1
11111112222                        1
111111111112222222222222222222222221
111111111111111111111111111111111111