TILEMAP
36 28 							-- Size of tile map in tiles
16 32 							-- Tile size & block size
images/blocks.png 	-- Tilesheet
2 2							-- Number of tiles in tilesheet
                                    
11111111111111        11111111111111
11    1                    111111111
11    1                       111111
11    1                         1111
11    1                           11
11    1                           11
11    1           11111           11
11    1                           11
11    1                           11
11    1                           11
11    1                           11
11                                11
11                                11
11                                11
111111111111111111111111111       11
111111111111111111111111111       11
1                      1111       11
1                      1111       11
1                      1111       11
1                                 11
1                                 11
1                                 11
1                                 11
111111                            11
111111   111     111    11111     11
111111222111222221112222111112222211
111111111111111111111111111111111111