TILEMAP
36 28 							-- Size of tile map in tiles
16 32 							-- Tile size & block size
images/blocks.png 	-- Tilesheet
2 2				    				-- Number of tiles in tilesheet
                                    
1111111111111111111111111111      11
1111111111111111111111111111      11
111111111111            1111      11
11111111                1111      11
11111111                1111      11
111111                  11        11
111111                  11        11
11                      11        11
11                      11        11
11              111            11111
11              111            11111
11111111111     111            11111
11111111111     111            11111
11111111111     111            11111
11111111111     111            11111
11111111111     111            11111
11111111111     111          1111111
11111111111     111               11
11111111111     111               11
11111111111     111               11
11111111111     111               11
11111111111     111               11
1               111               11
1               111               11
1               11122222222222222211
1               11111111111111111111
111111111111111111111111111111111111
