TILEMAP
36 28 							-- Size of tile map in tiles
16 32 							-- Tile size & block size
images/blocks.png 	-- Tilesheet
2 2 								-- Number of tiles in tilesheet
11111111111111111111111111     11111
11111111111111111111111111     11111
11111111111111111111111111     11111
11111111111111111111111111     11111
11111111111111111111111111     11111
111111111111   111111          11111
111111111111   111111          11111
     1111111                   11111
     1111111                   11111
     2222222                   11111
                               11111
                               11111
                             1111111
                             1111111
                             1111111
                                    
                                    
                                    
                                    
                                    
                                    
1111111                             
1111111                             
111111111111111               111111
111111111111111               111111
111111111111111      111111111111111
111111111111111      111111111111111
111111111111111      111111111111111