TILEMAP
36 28 							-- Size of tile map in tiles
16 32 							-- Tile size & block size
images/blocks.png 	-- Tilesheet
2 2 								-- Number of tiles in tilesheet
                                    
1111111111111              111111111
113                        111111111
113                        111111111
13                            111111
13                            111111
13                              1111
13       11111                  1111
112                             1111
111222                             1
111111                             1
1111112222222                      1
11111111111112                     1
111111111111112   2222             1
11111111111111111111113     1      1
111111111111111111111113           1
111111111111111111111113           1
11111111                           1
11111                              1
1                                  1
1                                  1
1                         4        1
1                         1        1
1                                  1
1                    1111          1
1                                  1
111111112222222222222222222222222221
111111111111111111111111111111111111