TILEMAP
36 28 							-- Size of tile map in tiles
16 32 							-- Tile size & block size
images/blocks.png 	-- Tilesheet
2 2 								-- Number of tiles in tilesheet
111111111111            111111111111
111111111111            111111111111
111111111111            111111111111
111111111111            111111111111
11111111                    11111111
11111111                    11111111
11112        4444              21111
11112                          21111
11112                          21111
11112           22222          21111
11112          2111112         21111
11                                11
11                                11
11        4444                    11
11                                11
11                                11
                        4444        
                                    
                                    
                                    
                                    
                                    
                                    
          4444      4444            
                                    
                                    
   11111                            
   11111                            