TILEMAP
36 28 							-- Size of tile map in tiles
16 32 							-- Tile size & block size
images/blocks.png 	-- Tilesheet
2 2 								-- Number of tiles in tilesheet
1111111111111                       
1112222222111                       
112       222              111111111
112                        111111111
12                   111     2111111
12                   222     2111111
12                            221111
12       11111                 21111
112                            21111
111222              1111        2221
1111112222                       221
1111111111222                      1
11111111111112                     1
1111111111111122222222             1
11111111111111111111112    111     1
111111111111111111111112   222     1
111111111111111111111112           1
11111111222222222222222            1
11111222                          11
11222                              1
12                                 1
1                                  1
1                         1111111111
1                                  1
1              1111                1
1                                  1
111111112222222222222222222222222221
111111111111111111111111111111111111