TILEMAP
36 28 							-- Size of tile map in tiles
16 32 							-- Tile size & block size
images/blocks.png 	-- Tilesheet
2 2 								-- Number of tiles in tilesheet
111111111111111111111      111111111
111111111111111111111      111111111
1111111111111111             1111111
1111111111111111             1111111
1111111111111111             1111111
1111111111111                1111111
1111111111111                  11111
1111111111111                  11111
11111111111                      111
11   111111                      111
       1111                         
       111111111                    
         1111111                    
         111111122222222            
                11111111            
                  1111          1111
                                1111
                                1111
                                1111
                                1111
                                1111
                22222222        1111
                11111111        1111
                  1111          1111
111111            1111          1111
111111      4     1111        441111
111111     111    1111        111111
111111     111    1111        111111