TILEMAP
36 28 							-- Size of tile map in tiles
16 32 							-- Tile size & block size
images/blocks.png 	-- Tilesheet
2 2 								-- Number of tiles in tilesheet
1111111111111111111111111111      11
111111111111111111                11
111111111111111111                11
1111111111111                     11
11111111                          11
11111111                          11
111111                            11
111111                      11111111
111111                11111111111111
111111                         11111
113333                         11111
113333                            11
113333                            11
113333                            11
111111111111                      11
111111111111                      11
11111                     1111111111
1111                        11111111
11                            111111
11                            111111
11              11111         111111
                11111         111111
       11111    11111         111111
       11111    11111         111111
111111111111222211111222222222111111
111111111111111111111111111111111111
111111111111111111111111111111111111
111111111111111111111111111111111111

