TILEMAP
36 28 							-- Size of tile map in tiles
16 32 							-- Tile size & block size
images/blocks.png 	-- Tilesheet
2 2								-- Number of tiles in tilesheet
                                    
111111111111111111111      111111111
1111111111111111             1111111
1111111111111111             1111111
1111111111111111             1111111
1111111111111                1111111
1111111111111            11111111111
1111111111111                    111
11111111111                      111
11   111111                      111
       11113                        
       111111111                    
         1111111     4              
         111111122222122            
                11111111            
                  1111          1111
                                1111
                                1111
                                1111
                                1111
                                1111
             222        222     1111
             111        111     1111
             111        111     1111
111111       111        111     1111
111111   4   111    4   111    41111
111111222122211122221222111    11111
111111111111111111111111111222211111